NO ./textures/backroom/girl.xpm
SO ./textures/backroom/carpet1.xpm
EA ./textures/backroom/ronce_jaune.xpm
WE ./textures/backroom/monstre2.xpm

F 135, 14, 12
C 230, 173, 189


11111111111111111111111
11111111111111111111111
11111111111111111111111
11111111111111111111111

