NO ./textures/backroom/girl.xpm
SO ./textures/backroom/carpet1.xpm
EA ./textures/backroom/ronce_jaune.xpm
WE ./textures/backroom/monstre2.xpm

F 135, 14, 12
C 230, 173, 189


        1111111111111111111111111
         000000000110000000000001
        10110000011100E0000000001
        1001000000000000000000001
111111111011000001110000111111001
100000000011000001110111111111111
11110111111111011100000010001
11110111111111010001010100001
11000000110101010000000000001
10000000000000001000000100001
10000000000000001000000110001
1100000111010101111000011000111
11110111 1110101 100000010001
11111111 1111111 111111111111
