NO ./textures/backroom/monstre.xpm
SO ./textures/backroom/girl.xpm
EA ./textures/backroom/carpet1.xpm
WE ./textures/backroom/ronce.xpm

F 01474836450,56,04
C 17, 55, 99


        1111111111111111111111111
        1000000000110000000000001
        1011000001110000000000001
        1001000000000000000000001
111111111011000001110000111111001
100000000011000001110111111111111
11110111111111011100000010001
11110111111111010001010100001
11000000110101010000000000001
10000000000000001000000100001
10000000000000001000N00110001
1100000111010101111000011000111
11110111 1110101 100000010001
11111111 1111111 111111111111
