NO ./textures/ocean_textures/farground.xpm
SO ./textures/grass.xpm
EA ./textures/purplestone.xpm
WE ./textures/ocean_textures/bla.xpm

FF   70,56,04
C 17, 55, 99

11111111111111111111111111111111111111111111111111111111111111111111111111111111
10000000000000000000100000000000000000000000000000000000000000000000000000000001
10000000001000000000100000000000000000000000000000000000000000000000000000000001
10000000001000000000100000000000000000000000010000000000000000000000000000000001
11111111111011111111100000000000001000000000010000000000000000000000000000000001
10000000000000000000100000000000001000000000010000000000000000000000000000000001
10000000000000000000100000000000001000000000010000000000000000000000000000000001
10000000000000000000100000000000001000000000010000000000000000000000000000000001
10000000000000000000100000000000001000000000010000000000000000000000000000000001
10000000000000000000100000000000001000000000010000000000000000000000000000000001
10000000000000000000100000000000001000000000010000000000000000000000000000000001
100000000000000000001000000000000010000000000000000000000000000W0000000000000001
10000000000000000000111111111111111000000000000000000000000000000000000000000001
10000000000000000000000000000000000000000000000000000000000000000000000000000001
10000000000000000000000000000000000000000000000000000000000000000000000000000001
10010000000100000111111111111000100000010000001000000000000000000000000000000001
10010100000100000000000100000000101000110000001000000000000000000000000000000001
10010010000100000000000100000000100101010000001000000000000100000000000000000001
10010001000100000000000100000000100010010000001000000000000000000000000000000001
10010000100100000000000100000000100000010000001000000000000000000000000000000001
10010000010100000000000100000000100000010000000000000000000000000000000000000001
10010000001100000000000100000000100000010000000000000000000000000000000000000001
10010000000100000000000100000000100000010000001000000000000000000000000000000001
11111111111111111111111111111111111111111111111111111111111111111111111111111111
