NO ./textures/ocean_textures/farground.xpm
SO ./textures/grass.xpm
EA ./textures/purplestone.xpm
WE ./textures/ocean_textures/bla.xpm

F 135, 14, 12
C 230, 173, 1


1111111111111111111111111111111
10000000001100000000000000000001
1011000001110000000000N000000001
10010000000000000000000000000111
111111111011000001110000111111001
100000000011000001110111111111111
111101000000010111000000100000001
111111111111111111111111111111111

