NO ./textures/ocean_textures/farground.xpm
SO ./textures/grass.xpm
EA ./textures/purplestone.xpm
WE ./textures/ocean_textures/bla.xpm

F 135, 14, 12
C 230, 173, 189


11111111111111111111111111111111
100000000011000000000000000000001
101100000111000000000000000000001
100100000000000000000000000000111
111111111011000001110000111111001
100000000011000001110111111111111
100000001000110111100000100000001
100010000S0000100010101000000001
110000000000000100000000000000011
1000000010001000000001001000001
1000000000000000000001100000001
11000000000000000000000011000011
11110100000001011100000010000001
1000000010001000000001001000001
1000000000000000000001100000001
11000000000000000000000011000011
111101000000010111000000100000001
111111111111111111111111111111111
