NO ./textures/ocean_textures/farground.xpm
SO ./textures/under_waves.xpm
EA ./textures/purplestone.xpm
WE ./textures/ocean_textures/bla.xpm

F 237,195,24
C 230, 173, 189


111111111111111111111111111111111
100000000011000000000000000000001
101100000111000000000000000000001
100100000000000000000000000000001
111111111011000001110000111111001
100000000011000001110111111111111
111100000000000111100000100000001
100000000000000100010101000000001
110000000001010100000000000000001
100000E00000000010000001001000001
100000000000000010000001100000001
110000000000010000000001100000001
111101011111010111000000100000001
111111111111111111111111111111111

