NO ../textures/wall.xpm
SO ../textures/purplestone.xpm
WE ../textures/greystone.xpm
EA ../textures/red.xpm

F 70,56,04
C 17, 55, 99




111111111111111111110111111111111
100000000011000000000000000000001
10110000011100E000000000000000001
100100000000000000000000000000001
111111111011000001110000111111001
100000000011000001110111111111111
111101111111110111000000100000001
111101111111110100010101000000001
110000001101010100000000000000001
100000000000000010000001000000001
100000000000000010000001100000001
110000011101010111100001100000001
111101111111010111000000100000001
111111111111111111111111111111111
