NO ./textures/ocean_textures/farground.xpm
SO ./textures/grass.xpm
EA ./textures/marine.xpm
WE ./textures/ocean_textures/bla.xpm

F 135, 14, 52
C 230, 173, 189


1111111111111111111111111111111
100000000011000000000000000000001
101100000111000000000000000000001
100100000000000000000000000000111
111111111011000001110000111111001
100000000011000001110111111111111
100000000000000111100000100000001
100000000000000100010101000000001
110000000000000100000000000000001
100000E00000000000000001001000001
100000000    00000000001100000001
110000000000000000000001100000001
111101000000010111000000100000001
111111111111111111111111111111111

