NO ./textures/wall.xpm
SO ./textures/purplestone.xpm
EA ./textures/greystone.xpm
WE ./textures/grass.xpm

111111111111111111111111111111111
100000000011000000000000000000001
101100000111000000000000000000001
100100000000000000000000000000001
111111111011000001110000111111001
100000000011000001110111111111111
111101111111110111000000100000001
111101111111110100010101000000001
110000001101010100000000000000001
1000000000000000100E0001001000001
100000000000000010000001100000001
110000011101010111100001100000001
111101111111010111000000100000001
111111111111111111111111111111111

F 70,56,04
C 17, 55, 250


