NO ./textures/wall.xpm
SO ./textures/purplestone.xpm
EA ./textures/greystone.xpm
WE ./textures/grass.xpm


F 70,56,04
C 17, 55, 250

111111111111111111111111111111111
100000000000000000000000000000001
100000000000000000000000000000001
100000000000000000000000000000001
100000000000000000000000000000001
100000000000000000000000000000001
100000000000000000000000000000001
100000000000000000000000000000001
100000000000000000000000000000001
10000000000000000N000000000000001
100000000000000000000000000000001
100000000000000000000000000000001
100000000000000000000000000000001
111111111111111111111111111111111
