11111111111
10000000001
11100001111
11111000011
10000000001
11111111111
